####################
#K                 #
# ###  ### ### ### #
# # #  ### #       #
# ###  ### ####### #
#                  #
# # ###### ####### #
# #      # # *   # #
# #####  #       # #
#   T    # #     # #
# ############# ## #
#   #       #      #
#   #       #      #
# ### #### #### ## #
# #    #     #   # #
# #### ### #### ## #
# #    #         ###
# ## ############# #
#        P         #
#########E##########