####################
#                  #
# ###  ### ### ### #
# # #  ### #       #
# ###  ### ####### #
#                  #
# # ###### ####### #
# #      # # *   # #
# #####  #       # #
#        # #     # #
# ############# ## #
#   #       #      #
#   #       #      #
# ### #### #### ## #
# #    #     #   # #
# #### ### #### ## #
# #    #         ###
# ## ############# #
#      K P         #
#########E##########