####################
#                  #
# ###  ### ### ### #
# # #  ### #  M    #
# ###  ### ####### #
#                  #
# # ###### ####### #
# #      # # *   # #
# #####  #    M  # #
#   m    # #     # #
# ############# ## #
#   #       #  M   #
#   #       #      #
# ### #### #### ## #
# #  M #     #   # #
# #### ### #### ## #
# #    #         ###
# ## ############# #
#      K H         #
#########D##########