



              #######
              #     E
              # #####
              #  K  #
              ##### #
              #P    #
              #######