



          #######
          #     E
          # #####
          #  K  #
          ##### #
          #P   V#
          #######